WWWWWWWWWWW
WWWWWWWWWWW
WWPPPFPPPWW
WWPFFFFFPWW
WWPFPPPPPWW
WWPFFFFFPWW
WWPPPPPFPWW
WDFFFFPFFDW
WDFFPFFFFDW
WWPFPPPPPWW
WWPFFFFFPWW
WWPPPPPFPWW
WWPFFFFFPWW
WWPPPFPPPWW
WWWWWWWWWWW
WWWWWWWWWWW