WWWWWWWWWWW
WWWWWWWWWWW
WWBBBFFFFWW
WWBBBFFFFWW
WWBBFFFBFWW
WWBBFFFFFWW
WWBFFFFFFWW
WDFFFFFFFWW
WDFFFFFFFWW
WWBFFFFFFWW
WWBBFFFFFWW
WWBBFFFBFWW
WWBBBFFFFWW
WWBBBFFFFWW
WWWWDDDWWWW
WWWWWWWWWWW