WWWWWWWWWWW
WWWWWWWWWWW
WWFFFFFFFWW
WWFBBBBBFWW
WWFFFFFFFWW
WWFBBBBBFWW
WWFFFFFFFWW
WDFBBBBBFDW
WDFBBBBBFDW
WWFFFFFFFWW
WWFBBBBBFWW
WWFFFFFFFWW
WWFBBBBBFWW
WWFFFFFFFWW
WWWWWWWWWWW
WWWWWWWWWWW