WWWWWWWWWWW
WWWWDDDWWWW
WWFFFFFFFWW
WWBBBBBFFWW
WWFFFFBFBWW
WWBBFBBFFWW
WWFBFFFFFWW
WWFBBBBBFWW
WWFFFFFFFWW
WWFBFFFBBWW
WWFBFFFFFWW
WWFBBBBBFWW
WWFFBFFFFWW
WWFFBFFBBWW
WWWWDDDWWWW
WWWWWWWWWWW