WWWWWWWWWWW
WWWWDDDWWWW
WWFFPFFFFWW
WWFFPFFFFWW
WWFFPFFFFWW
WWFFPFFFFWW
WWFFPFFFFWW
WWFFPFFFFWW
WWFFPFFFFWW
WWFFPFFFFWW
WWFFPFFFFWW
WWFFPFFFFWW
WWFFPFFFFWW
WWFFPFFFFWW
WWWWWWWWWWW
WWWWWWWWWWW