WWWWWWWWWWW
WWWWWWWWWWW
WWFFFFFFBWW
WWFBFFFBFWW
WWBFFFBFFWW
WWFFFBFFFWW
WWFFBFFFFWW
WDFBFFFFFDW
WDFFFFFBFDW
WWFFFFBFFWW
WWFFFBFFFWW
WWFFBFFFBWW
WWFBFFFBFWW
WWBFFFFFFWW
WWWWWWWWWWW
WWWWWWWWWWW