WWWWWWWWWWW
WWWWDDDWWWW
WWFFFFFFFWW
WWFFFFFFFWW
WWFFFFFFFWW
WWFFFFFFFWW
WWFFFFFFFWW
WDFFFFFFFWW
WDFFFFFFFWW
WWBFFFFFBWW
WWBFFFFFBWW
WWBBFFFBBWW
WWBBBFBBBWW
WWBBBFBBBWW
WWWWWWWWWWW
WWWWWWWWWWW