WWWWWWWWWWW
WWWWDDDWWWW
WWFFFFFFFWW
WWFBFFFBFWW
WWFBFFFBFWW
WWFFFFFFFWW
WWFFFFFFFWW
WWFFFBFFFWW
WWFFFBFFFWW
WWFFFFFFFWW
WWFFFFFFFWW
WWFBFFFBFWW
WWFBFFFBFWW
WWFFFFFFFWW
WWWWWWWWWWW
WWWWWWWWWWW