WWWWWWWWWWW
WWWWWWWWWWW
WWPPPFPPPWW
WWPFFFFFPWW
WWPFPPPFPWW
WWPFPFPFPWW
WWPPPFPPPWW
WDFPFFFPFWW
WDFPFFFPFWW
WWPPPFPPPWW
WWPFPFPFPWW
WWPFPPPFPWW
WWPFFFFFPWW
WWPPPFPPPWW
WWWWDDDWWWW
WWWWWWWWWWW