WWWWWWWWWWW
WWWWWWWWWWW
WWFFFFFFFWW
WWFBFFFBFWW
WWFBFFFBFWW
WWFBFFFBFWW
WWFBFFFBFWW
WWFBFFFBFWW
WWFBFFFBFWW
WWFBFFFBFWW
WWFBFFFBFWW
WWFBFFFBFWW
WWFBBBBBFWW
WWFFFFFFFWW
WWWWWWWWWWW
WWWWWWWWWWW