WWWWWWWWWWW
WWWWDDDWWWW
WWFFPFFFFWW
WWFFPFFFFWW
WWFFPFFFFWW
WWFFPFFFFWW
WWFFPFFFFWW
WDFFPFFFFWW
WDFFPFFFFWW
WWFFPFFFFWW
WWFFPFFFFWW
WWFFPFFFFWW
WWFFPFFFFWW
WWFFPFFFFWW
WWWWDDDWWWW
WWWWWWWWWWW