WWWWWWWWWWW
WWWWDDDWWWW
WWFFBFBFFWW
WWFFBFBFFWW
WWFFBFBFFWW
WWFFBFBFFWW
WWFFBFBFFWW
WWFFBFBFFDW
WWFFBFBFFDW
WWFFBFBFFWW
WWFFBFBFFWW
WWFFBFBFFWW
WWFFBFBFFWW
WWFFBFBFFWW
WWWWDDDWWWW
WWWWWWWWWWW