WWWWWWWWWWW
WWWWWWWWWWW
WWFFIFIFFWW
WWFFIFIFFWW
WWFFIFIFFWW
WWFFIFIFFWW
WWFFIFIFFWW
WWFFIFIFFDW
WWFFIFIFFDW
WWFFIFIFFWW
WWFFIFIFFWW
WWFFIFIFFWW
WWFFIFIFFWW
WWFFIFIFFWW
WWWWWWWWWWW
WWWWWWWWWWW