WWWWWWWWWWW
WWWWWWWWWWW
WWFFFFFFFWW
WWFFFFFFFWW
WWFFFFFFFWW
WWFFFFFFFWW
WWFFFFFFFWW
WWFFFBFFFDW
WWFFFFFFFDW
WWFFFFFFFWW
WWFFFFFFFWW
WWFFFFFFFWW
WWFFFFFFFWW
WWFFFFFFFWW
WWWWDDDWWWW
WWWWWWWWWWW