WWWWWWWWWWW
WWWWDDDWWWW
WWPPPPPPPWW
WWPPPPPPPWW
WWPPPPPPPWW
WWPPPPPPPWW
WWPPPPPPPWW
WDPPPPPPPWW
WDPPPPPPPWW
WWPPPPPPPWW
WWPPPPPPPWW
WWPPPPPPPWW
WWPPPPPPPWW
WWPPPPPPPWW
WWWWWWWWWWW
WWWWWWWWWWW