WWWWWWWWWWW
WWWWWWWWWWW
WWFFFFFFFWW
WWFBFBFBFWW
WWFFFFFFFWW
WWFBFBFBFWW
WWFFFFFFFWW
WWFBFBFBFDW
WWFBFBFBFDW
WWFFFFFFFWW
WWFBFBFBFWW
WWFFFFFFFWW
WWFBFBFBFWW
WWFFFFFFFWW
WWWWDDDWWWW
WWWWWWWWWWW