WWWWWWWWWWW
WWWWWWWWWWW
WWMFFFFFMWW
WWFFFFFFFWW
WWFFFFFFFWW
WWFFFFFFFWW
WWFFFFFFFWW
WDFFFFFFFWW
WDFFFFFFFWW
WWFFFFFFFWW
WWFFFFFFFWW
WWFFFFFFFWW
WWFFFFFFFWW
WWMFFFFFMWW
WWWWWWWWWWW
WWWWWWWWWWW