WWWWWWWWWWW
WWWWDDDWWWW
WWFFFFFFFWW
WWIIIIIFFWW
WWFFFFIFIWW
WWIIFIIFFWW
WWFIFFFFFWW
WWFIIIIIFWW
WWFFFFFFFWW
WWFIFFFIIWW
WWFIFFFFFWW
WWFIIIIIFWW
WWFFIFFFFWW
WWFFIFFIIWW
WWWWWWWWWWW
WWWWWWWWWWW