WWWWWWWWWWW
WWWWDDDWWWW
WWFFFFFFFWW
WWFFFIFFFWW
WWFFIFIFFWW
WWFFFFFFFWW
WWFFFFFFFWW
WWFFFFFFFDW
WWFFFFFFFDW
WWFFFFFFFWW
WWFFFFFFFWW
WWFFIFIFFWW
WWFFFIFFFWW
WWFFFFFFFWW
WWWWWWWWWWW
WWWWWWWWWWW