WWWWWWWWWWW
WWWWDDDWWWW
WWFFFFFFFWW
WWFBFFFBFWW
WWFBFFFBFWW
WWFBFFFBFWW
WWFBFFFBFWW
WWFBFFFBFDW
WWFBFFFBFDW
WWFBFFFBFWW
WWFBFFFBFWW
WWFBFFFBFWW
WWFBBBBBFWW
WWFFFFFFFWW
WWWWWWWWWWW
WWWWWWWWWWW