WWWWWWWWWWW
WWWWWWWWWWW
WWFFFFFFFWW
WWFPPPPPFWW
WWFPFFFPFWW
WWFPFFFPFWW
WWFPFFFPFWW
WDFPFFFPFWW
WDFPFFFPFWW
WWFPFFFPFWW
WWFPFFFPFWW
WWFPFFFPFWW
WWFPPPPPFWW
WWFFFFFFFWW
WWWWWWWWWWW
WWWWWWWWWWW