WWWWWWWWWWW
WWWWDDDWWWW
WWFFFFFFFWW
WWFBFBFBFWW
WWFFFFFFFWW
WWFBFBFBFWW
WWFFFFFFFWW
WDFBFBFBFDW
WDFBFBFBFDW
WWFFFFFFFWW
WWFBFBFBFWW
WWFFFFFFFWW
WWFBFBFBFWW
WWFFFFFFFWW
WWWWDDDWWWW
WWWWWWWWWWW