WWWWWWWWWWW
WWWWDDDWWWW
WWFFFFFFFWW
WWFBFFFBFWW
WWFBFFFBFWW
WWFBFFFBFWW
WWFBFFFBFWW
WWFBFFFBFWW
WWFBFFFBFWW
WWFBFFFBFWW
WWFBFFFBFWW
WWFBFFFBFWW
WWFBBBBBFWW
WWFFFFFFFWW
WWWWDDDWWWW
WWWWWWWWWWW