WWWWWWWWWWW
WWWWWWWWWWW
WWFFFFFFFWW
WWFFFFFFFWW
WWFFBBBFFWW
WWFFBBBFFWW
WWFFFFFFFWW
WWFFFFFFFDW
WWFFFFFFFDW
WWFFFFFFFWW
WWFFBBBFFWW
WWFFBBBFFWW
WWFFFFFFFWW
WWFFFFFFFWW
WWWWWWWWWWW
WWWWWWWWWWW