WWWWWWWWWWW
WWWWDDDWWWW
WWFFFFFFFWW
WWFFFFFFFWW
WWFFFFFFFWW
WWFFFFFFFWW
WWBBBBBBBWW
WWFFFFFFFDW
WWFFFFFFFDW
WWBBBBBBBWW
WWFFFFFFFWW
WWFFFFFFFWW
WWFFFFFFFWW
WWFFFFFFFWW
WWWWWWWWWWW
WWWWWWWWWWW