WWWWWWWWWWW
WWWWWWWWWWW
WWPPPPPPPWW
WWPPPPPPPWW
WWPPPPPPPWW
WWPPPPPPPWW
WWPPPPPPPWW
WDPPPPPPPDW
WDPPPPPPPDW
WWPPPPPPPWW
WWPPPPPPPWW
WWPPPPPPPWW
WWPPPPPPPWW
WWPPPPPPPWW
WWWWWWWWWWW
WWWWWWWWWWW