WWWWWWWWWWW
WWWWWWWWWWW
WWPPPFPPPWW
WWPFFFFFPWW
WWPFPPPPPWW
WWPFFFFFPWW
WWPPPPPFPWW
WDFFFFPFFWW
WDFFPFFFFWW
WWPFPPPPPWW
WWPFFFFFPWW
WWPPPPPFPWW
WWPFFFFFPWW
WWPPPFPPPWW
WWWWWWWWWWW
WWWWWWWWWWW