WWWWWWWWWWW
WWWWWWWWWWW
WWFFFFFFFWW
WWFFFFFFFWW
WWFFFFFFFWW
WWFFFFFFFWW
WWFFFFFFFWW
WWFFFFFFFDW
WWFFFFFFFDW
WWBFFFFFBWW
WWBFFFFFBWW
WWBBFFFBBWW
WWBBBFBBBWW
WWBBBFBBBWW
WWWWDDDWWWW
WWWWWWWWWWW