WWWWWWWWWWW
WWWWWWWWWWW
WWFFPFFFFWW
WWFFPFFFFWW
WWFFPFFFFWW
WWFFPFFFFWW
WWFFPFFFFWW
WDFFPFFFFWW
WDFFPFFFFWW
WWFFPFFFFWW
WWFFPFFFFWW
WWFFPFFFFWW
WWFFPFFFFWW
WWFFPFFFFWW
WWWWWWWWWWW
WWWWWWWWWWW