WWWWWWWWWWW
WWWWDDDWWWW
WWMFFFFFMWW
WWFFFFFFFWW
WWFFFFFFFWW
WWFFFFFFFWW
WWFFFFFFFWW
WWFFFFFFFWW
WWFFFFFFFWW
WWFFFFFFFWW
WWFFFFFFFWW
WWFFFFFFFWW
WWFFFFFFFWW
WWMFFFFFMWW
WWWWWWWWWWW
WWWWWWWWWWW