WWWWWWWWWWW
WWWWWWWWWWW
WWFFFFFFFWW
WWBBBBBFFWW
WWFFFFBFBWW
WWBBFBBFFWW
WWFBFFFFFWW
WWFBBBBBFDW
WWFFFFFFFDW
WWFBFFFBBWW
WWFBFFFFFWW
WWFBBBBBFWW
WWFFBFFFFWW
WWFFBFFBBWW
WWWWDDDWWWW
WWWWWWWWWWW